0, -1, -1, -1, -1, -1, 0, 0, 0
0, -1, -1, -1, -1, -1, 0, 0, 0
0, -1, -1, -1, -1, -1, 0, 0, 0
0, -1, -1, -1, -1, -1, 0, 0, 0
0, -1, -1, -1, -1, -1, 0, 0, 0
1, 5, 0, -1, -1, -1, 0, 0, 0
0, -1, -1, -1, -1, -1, 0, 0, 0
0, -1, -1, -1, -1, -1, 0, 0, 0
0, -1, -1, -1, -1, -1, 0, 0, 0
0, -1, -1, -1, -1, -1, 0, 0, 0
0, -1, -1, -1, -1, -1, 0, 0, 0
0, -1, -1, -1, -1, -1, 0, 0, 0
0, -1, -1, -1, -1, -1, 0, 0, 0
0, -1, -1, -1, -1, -1, 0, 0, 0
0, -1, -1, -1, -1, -1, 0, 0, 0
0, -1, -1, -1, -1, -1, 0, 0, 0
3, 5, 1, -1, -1, -1, 0, 0, 0
0, -1, -1, -1, -1, -1, 0, 0, 0
0, -1, -1, -1, -1, -1, 0, 0, 0
0, -1, -1, -1, -1, -1, 0, 0, 0
0, -1, -1, -1, -1, -1, 0, 0, 0
0, -1, -1, -1, -1, -1, 0, 0, 0
0, -1, -1, -1, -1, -1, 0, 0, 0
0, -1, -1, -1, -1, -1, 0, 0, 0
0, -1, -1, -1, -1, -1, 0, 0, 0
0, -1, -1, -1, -1, -1, 0, 0, 0
5, 4, 2, 5, -1, -1, 0, 0, 0
3, 5, 2, -1, -1, -1, 0, 0, 0
0, -1, -1, -1, -1, -1, 0, 0, 0
0, -1, -1, -1, -1, -1, 0, 0, 0
0, -1, -1, -1, -1, -1, 0, 0, 0
0, -1, -1, -1, -1, -1, 0, 0, 0
0, -1, -1, -1, -1, -1, 0, 0, 0
0, -1, -1, -1, -1, -1, 0, 0, 0
1, 1, 3, -1, -1, -1, 0, 0, 0
3, 2, 3, -1, -1, -1, 0, 0, 0
3, 3, 3, -1, -1, -1, 0, 0, 0
4, 4, 3, -1, -1, -1, 0, 0, 0
4, 5, 3, -1, -1, -1, 0, 0, 0
3, 6, 3, -1, -1, -1, 0, 0, 0
3, 7, 3, -1, -1, -1, 0, 0, 0
1, 8, 3, -1, -1, -1, 0, 0, 0
0, -1, -1, -1, -1, -1, 0, 0, 0
0, -1, -1, -1, -1, -1, 0, 0, 0
0, -1, -1, -1, -1, -1, 0, 0, 0
0, -1, -1, -1, -1, -1, 0, 0, 0
0, -1, -1, -1, -1, -1, 0, 0, 0
0, -1, -1, -1, -1, -1, 0, 0, 0
2, 4, 4, -1, -1, -1, 0, 0, 0
4, 5, 4, -1, -1, -1, 0, 0, 0
5, 6, 4, 5, -1, -1, 0, 0, 0
0, -1, -1, -1, -1, -1, 0, 0, 0
0, -1, -1, -1, -1, -1, 0, 0, 0
0, -1, -1, -1, -1, -1, 0, 0, 0
0, -1, -1, -1, -1, -1, 0, 0, 0
0, -1, -1, -1, -1, -1, 0, 0, 0
0, -1, -1, -1, -1, -1, 0, 0, 0
0, -1, -1, -1, -1, -1, 0, 0, 0
0, -1, -1, -1, -1, -1, 0, 0, 0
0, -1, -1, -1, -1, -1, 0, 0, 0
3, 5, 5, -1, -1, -1, 0, 0, 0
0, -1, -1, -1, -1, -1, 0, 0, 0
0, -1, -1, -1, -1, -1, 0, 0, 0
0, -1, -1, -1, -1, -1, 0, 0, 0
0, -1, -1, -1, -1, -1, 0, 0, 0
0, -1, -1, -1, -1, -1, 0, 0, 0
0, -1, -1, -1, -1, -1, 0, 0, 0
0, -1, -1, -1, -1, -1, 0, 0, 0
0, -1, -1, -1, -1, -1, 0, 0, 0
0, -1, -1, -1, -1, -1, 0, 0, 0
0, -1, -1, -1, -1, -1, 0, 0, 0
3, 5, 6, -1, -1, -1, 0, 0, 0
0, -1, -1, -1, -1, -1, 0, 0, 0
0, -1, -1, -1, -1, -1, 0, 0, 0
0, -1, -1, -1, -1, -1, 0, 0, 0
0, -1, -1, -1, -1, -1, 0, 0, 0
0, -1, -1, -1, -1, -1, 0, 0, 0
0, -1, -1, -1, -1, -1, 0, 0, 0
0, -1, -1, -1, -1, -1, 0, 0, 0
0, -1, -1, -1, -1, -1, 0, 0, 0
0, -1, -1, -1, -1, -1, 0, 0, 0
0, -1, -1, -1, -1, -1, 0, 0, 0
1, 5, 7, -1, -1, -1, 0, 0, 0
0, -1, -1, -1, -1, -1, 0, 0, 0
0, -1, -1, -1, -1, -1, 0, 0, 0
0, -1, -1, -1, -1, -1, 0, 0, 0
0, -1, -1, -1, -1, -1, 0, 0, 0
0, -1, -1, -1, -1, -1, 0, 0, 0
