0, -1, -1, -1, -1, -1, 0, 0, 0
0, -1, -1, -1, -1, -1, 0, 0, 0
0, -1, -1, -1, -1, -1, 0, 0, 0
0, -1, -1, -1, -1, -1, 0, 0, 0
0, -1, -1, -1, -1, -1, 0, 0, 0
0, -1, -1, -1, -1, -1, 0, 0, 0
0, -1, -1, -1, -1, -1, 0, 0, 0
0, -1, -1, -1, -1, -1, 0, 0, 0
0, -1, -1, -1, -1, -1, 0, 0, 0
0, -1, -1, -1, -1, -1, 0, 0, 0
0, -1, -1, -1, -1, -1, 0, 0, 0
0, -1, -1, -1, -1, -1, 0, 0, 0
0, -1, -1, -1, -1, -1, 0, 0, 0
1, 2, 1, -1, -1, -1, 0, 0, 0
5, 3, 1, 5, -1, -1, 0, 0, 0
9, 4, 1, -1, -1, -1, 0, 0, 0
0, -1, -1, -1, -1, -1, 0, 0, 0
1, 6, 1, -1, -1, -1, 0, 0, 0
4, 7, 1, -1, -1, -1, 0, 0, 0
9, 8, 1, -1, -1, -1, 0, 0, 0
0, -1, -1, -1, -1, -1, 0, 0, 0
0, -1, -1, -1, -1, -1, 0, 0, 0
0, -1, -1, -1, -1, -1, 0, 0, 0
0, -1, -1, -1, -1, -1, 0, 0, 0
0, -1, -1, -1, -1, -1, 0, 0, 0
0, -1, -1, -1, -1, -1, 0, 0, 0
0, -1, -1, -1, -1, -1, 0, 0, 0
0, -1, -1, -1, -1, -1, 0, 0, 0
0, -1, -1, -1, -1, -1, 0, 0, 0
0, -1, -1, -1, -1, -1, 0, 0, 0
0, -1, -1, -1, -1, -1, 0, 0, 0
0, -1, -1, -1, -1, -1, 0, 0, 0
0, -1, -1, -1, -1, -1, 0, 0, 0
0, -1, -1, -1, -1, -1, 0, 0, 0
0, -1, -1, -1, -1, -1, 0, 0, 0
1, 2, 3, -1, -1, -1, 0, 0, 0
4, 3, 3, -1, -1, -1, 0, 0, 0
9, 4, 3, -1, -1, -1, 0, 0, 0
0, -1, -1, -1, -1, -1, 0, 0, 0
1, 6, 3, -1, -1, -1, 0, 0, 0
3, 7, 3, -1, -1, -1, 0, 0, 0
2, 8, 3, -1, -1, -1, 0, 0, 0
0, -1, -1, -1, -1, -1, 0, 0, 0
0, -1, -1, -1, -1, -1, 0, 0, 0
0, -1, -1, -1, -1, -1, 0, 0, 0
0, -1, -1, -1, -1, -1, 0, 0, 0
0, -1, -1, -1, -1, -1, 0, 0, 0
0, -1, -1, -1, -1, -1, 0, 0, 0
0, -1, -1, -1, -1, -1, 0, 0, 0
0, -1, -1, -1, -1, -1, 0, 0, 0
0, -1, -1, -1, -1, -1, 0, 0, 0
0, -1, -1, -1, -1, -1, 0, 0, 0
0, -1, -1, -1, -1, -1, 0, 0, 0
0, -1, -1, -1, -1, -1, 0, 0, 0
0, -1, -1, -1, -1, -1, 0, 0, 0
0, -1, -1, -1, -1, -1, 0, 0, 0
0, -1, -1, -1, -1, -1, 0, 0, 0
1, 2, 5, -1, -1, -1, 0, 0, 0
5, 3, 5, 5, -1, -1, 0, 0, 0
9, 4, 5, -1, -1, -1, 0, 0, 0
0, -1, -1, -1, -1, -1, 0, 0, 0
1, 6, 5, -1, -1, -1, 0, 0, 0
4, 7, 5, -1, -1, -1, 0, 0, 0
9, 8, 5, -1, -1, -1, 0, 0, 0
0, -1, -1, -1, -1, -1, 0, 0, 0
0, -1, -1, -1, -1, -1, 0, 0, 0
0, -1, -1, -1, -1, -1, 0, 0, 0
0, -1, -1, -1, -1, -1, 0, 0, 0
0, -1, -1, -1, -1, -1, 0, 0, 0
0, -1, -1, -1, -1, -1, 0, 0, 0
0, -1, -1, -1, -1, -1, 0, 0, 0
0, -1, -1, -1, -1, -1, 0, 0, 0
0, -1, -1, -1, -1, -1, 0, 0, 0
0, -1, -1, -1, -1, -1, 0, 0, 0
0, -1, -1, -1, -1, -1, 0, 0, 0
0, -1, -1, -1, -1, -1, 0, 0, 0
0, -1, -1, -1, -1, -1, 0, 0, 0
0, -1, -1, -1, -1, -1, 0, 0, 0
0, -1, -1, -1, -1, -1, 0, 0, 0
0, -1, -1, -1, -1, -1, 0, 0, 0
0, -1, -1, -1, -1, -1, 0, 0, 0
0, -1, -1, -1, -1, -1, 0, 0, 0
0, -1, -1, -1, -1, -1, 0, 0, 0
0, -1, -1, -1, -1, -1, 0, 0, 0
0, -1, -1, -1, -1, -1, 0, 0, 0
0, -1, -1, -1, -1, -1, 0, 0, 0
0, -1, -1, -1, -1, -1, 0, 0, 0
0, -1, -1, -1, -1, -1, 0, 0, 0
