0, -1, -1, -1, -1, -1, 0, 0, 0
0, -1, -1, -1, -1, -1, 0, 0, 0
0, -1, -1, -1, -1, -1, 0, 0, 0
0, -1, -1, -1, -1, -1, 0, 0, 0
0, -1, -1, -1, -1, -1, 0, 0, 0
0, -1, -1, -1, -1, -1, 0, 0, 0
0, -1, -1, -1, -1, -1, 0, 0, 0
0, -1, -1, -1, -1, -1, 0, 0, 0
0, -1, -1, -1, -1, -1, 0, 0, 0
0, -1, -1, -1, -1, -1, 0, 0, 0
0, -1, -1, -1, -1, -1, 0, 0, 0
0, -1, -1, -1, -1, -1, 0, 0, 0
0, -1, -1, -1, -1, -1, 0, 0, 0
0, -1, -1, -1, -1, -1, 0, 0, 0
0, -1, -1, -1, -1, -1, 0, 0, 0
0, -1, -1, -1, -1, -1, 0, 0, 0
3, 5, 1, -1, -1, -1, 0, 0, 0
4, 6, 1, -1, -1, -1, 0, 0, 0
3, 7, 1, -1, -1, -1, 0, 0, 0
0, -1, -1, -1, -1, -1, 0, 0, 0
0, -1, -1, -1, -1, -1, 0, 0, 0
0, -1, -1, -1, -1, -1, 0, 0, 0
0, -1, -1, -1, -1, -1, 0, 0, 0
3, 1, 2, -1, -1, -1, 0, 0, 0
5, 2, 2, 15, -1, -1, 0, 0, 0
3, 3, 2, -1, -1, -1, 0, 0, 0
0, -1, -1, -1, -1, -1, 0, 0, 0
3, 5, 2, -1, -1, -1, 0, 0, 0
0, -1, -1, -1, -1, -1, 0, 0, 0
3, 7, 2, -1, -1, -1, 0, 0, 0
0, -1, -1, -1, -1, -1, 0, 0, 0
0, -1, -1, -1, -1, -1, 0, 0, 0
0, -1, -1, -1, -1, -1, 0, 0, 0
0, -1, -1, -1, -1, -1, 0, 0, 0
3, 1, 3, -1, -1, -1, 0, 0, 0
0, -1, -1, -1, -1, -1, 0, 0, 0
3, 3, 3, -1, -1, -1, 0, 0, 0
0, -1, -1, -1, -1, -1, 0, 0, 0
3, 5, 3, -1, -1, -1, 0, 0, 0
0, -1, -1, -1, -1, -1, 0, 0, 0
3, 7, 3, -1, -1, -1, 0, 0, 0
0, -1, -1, -1, -1, -1, 0, 0, 0
0, -1, -1, -1, -1, -1, 0, 0, 0
0, -1, -1, -1, -1, -1, 0, 0, 0
0, -1, -1, -1, -1, -1, 0, 0, 0
1, 1, 4, -1, -1, -1, 0, 0, 0
5, 2, 4, 10, -1, -1, 0, 0, 0
3, 3, 4, -1, -1, -1, 0, 0, 0
3, 4, 4, -1, -1, -1, 0, 0, 0
4, 5, 4, -1, -1, -1, 0, 0, 0
3, 6, 4, -1, -1, -1, 0, 0, 0
4, 7, 4, -1, -1, -1, 0, 0, 0
0, -1, -1, -1, -1, -1, 0, 0, 0
0, -1, -1, -1, -1, -1, 0, 0, 0
0, -1, -1, -1, -1, -1, 0, 0, 0
0, -1, -1, -1, -1, -1, 0, 0, 0
3, 1, 5, -1, -1, -1, 0, 0, 0
0, -1, -1, -1, -1, -1, 0, 0, 0
3, 3, 5, -1, -1, -1, 0, 0, 0
0, -1, -1, -1, -1, -1, 0, 0, 0
0, -1, -1, -1, -1, -1, 0, 0, 0
0, -1, -1, -1, -1, -1, 0, 0, 0
3, 7, 5, -1, -1, -1, 0, 0, 0
0, -1, -1, -1, -1, -1, 0, 0, 0
0, -1, -1, -1, -1, -1, 0, 0, 0
0, -1, -1, -1, -1, -1, 0, 0, 0
0, -1, -1, -1, -1, -1, 0, 0, 0
3, 1, 6, -1, -1, -1, 0, 0, 0
5, 2, 6, 5, -1, -1, 0, 0, 0
3, 3, 6, -1, -1, -1, 0, 0, 0
3, 4, 6, -1, -1, -1, 0, 0, 0
2, 5, 6, -1, -1, -1, 0, 0, 0
3, 6, 6, -1, -1, -1, 0, 0, 0
3, 7, 6, -1, -1, -1, 0, 0, 0
0, -1, -1, -1, -1, -1, 0, 0, 0
0, -1, -1, -1, -1, -1, 0, 0, 0
0, -1, -1, -1, -1, -1, 0, 0, 0
0, -1, -1, -1, -1, -1, 0, 0, 0
0, -1, -1, -1, -1, -1, 0, 0, 0
0, -1, -1, -1, -1, -1, 0, 0, 0
0, -1, -1, -1, -1, -1, 0, 0, 0
0, -1, -1, -1, -1, -1, 0, 0, 0
0, -1, -1, -1, -1, -1, 0, 0, 0
0, -1, -1, -1, -1, -1, 0, 0, 0
0, -1, -1, -1, -1, -1, 0, 0, 0
0, -1, -1, -1, -1, -1, 0, 0, 0
0, -1, -1, -1, -1, -1, 0, 0, 0
0, -1, -1, -1, -1, -1, 0, 0, 0
