0 -1 -1 -1 -1 -1 0 0 0
0 -1 -1 -1 -1 -1 0 0 0
3 2 0 -1 -1 -1 0 0 0
3 3 0 -1 -1 -1 0 0 0
3 4 0 -1 -1 -1 0 0 0
3 5 0 -1 -1 -1 0 0 0
3 6 0 -1 -1 -1 0 0 0
3 7 0 -1 -1 -1 0 0 0
3 8 0 -1 -1 -1 0 0 0
0 -1 -1 -1 -1 -1 0 0 0
0 -1 -1 -1 -1 -1 0 0 0
0 -1 -1 -1 -1 -1 0 0 0
0 -1 -1 -1 -1 -1 0 0 0
3 2 1 -1 -1 -1 0 0 0
0 -1 -1 -1 -1 -1 0 0 0
0 -1 -1 -1 -1 -1 0 0 0
0 -1 -1 -1 -1 -1 0 0 0
0 -1 -1 -1 -1 -1 0 0 0
0 -1 -1 -1 -1 -1 0 0 0
3 8 1 -1 -1 -1 0 0 0
0 -1 -1 -1 -1 -1 0 0 0
0 -1 -1 -1 -1 -1 0 0 0
0 -1 -1 -1 -1 -1 0 0 0
0 -1 -1 -1 -1 -1 0 0 0
3 2 2 -1 -1 -1 0 0 0
0 -1 -1 -1 -1 -1 0 0 0
0 -1 -1 -1 -1 -1 0 0 0
0 -1 -1 -1 -1 -1 0 0 0
0 -1 -1 -1 -1 -1 0 0 0
0 -1 -1 -1 -1 -1 0 0 0
3 8 2 -1 -1 -1 0 0 0
0 -1 -1 -1 -1 -1 0 0 0
0 -1 -1 -1 -1 -1 0 0 0
0 -1 -1 -1 -1 -1 0 0 0
0 -1 -1 -1 -1 -1 0 0 0
3 2 3 -1 -1 -1 0 0 0
0 -1 -1 -1 -1 -1 0 0 0
4 4 3 -1 -1 -1 0 0 0
4 5 3 -1 -1 -1 0 0 0
1 6 3 -1 -1 -1 0 0 0
0 -1 -1 -1 -1 -1 0 0 0
3 8 3 -1 -1 -1 0 0 0
0 -1 -1 -1 -1 -1 0 0 0
0 -1 -1 -1 -1 -1 0 0 0
0 -1 -1 -1 -1 -1 0 0 0
0 -1 -1 -1 -1 -1 0 0 0
3 2 4 -1 -1 -1 0 0 0
0 -1 -1 -1 -1 -1 0 0 0
4 4 4 -1 -1 -1 0 0 0
0 -1 -1 -1 -1 -1 0 0 0
4 6 4 -1 -1 -1 0 0 0
0 -1 -1 -1 -1 -1 0 0 0
3 8 4 -1 -1 -1 0 0 0
0 -1 -1 -1 -1 -1 0 0 0
0 -1 -1 -1 -1 -1 0 0 0
0 -1 -1 -1 -1 -1 0 0 0
0 -1 -1 -1 -1 -1 0 0 0
3 2 5 -1 -1 -1 0 0 0
0 -1 -1 -1 -1 -1 0 0 0
2 4 5 -1 -1 -1 0 0 0
4 5 5 -1 -1 -1 0 0 0
4 6 5 -1 -1 -1 0 0 0
0 -1 -1 -1 -1 -1 0 0 0
3 8 5 -1 -1 -1 0 0 0
0 -1 -1 -1 -1 -1 0 0 0
0 -1 -1 -1 -1 -1 0 0 0
0 -1 -1 -1 -1 -1 0 0 0
0 -1 -1 -1 -1 -1 0 0 0
3 2 6 -1 -1 -1 0 0 0
0 -1 -1 -1 -1 -1 0 0 0
0 -1 -1 -1 -1 -1 0 0 0
0 -1 -1 -1 -1 -1 0 0 0
0 -1 -1 -1 -1 -1 0 0 0
0 -1 -1 -1 -1 -1 0 0 0
3 8 6 -1 -1 -1 0 0 0
0 -1 -1 -1 -1 -1 0 0 0
0 -1 -1 -1 -1 -1 0 0 0
0 -1 -1 -1 -1 -1 0 0 0
0 -1 -1 -1 -1 -1 0 0 0
3 2 7 -1 -1 -1 0 0 0
3 3 7 -1 -1 -1 0 0 0
3 4 7 -1 -1 -1 0 0 0
3 5 7 -1 -1 -1 0 0 0
3 6 7 -1 -1 -1 0 0 0
3 7 7 -1 -1 -1 0 0 0
3 8 7 -1 -1 -1 0 0 0
0 -1 -1 -1 -1 -1 0 0 0
0 -1 -1 -1 -1 -1 0 0 0
