0 -1 -1 -1 -1 -1 0 0 0
0 -1 -1 -1 -1 -1 0 0 0
0 -1 -1 -1 -1 -1 0 0 0
0 3 0 -1 -1 -1 0 0 0
4 4 0 -1 -1 -1 0 0 0
1 5 0 -1 -1 -1 0 0 0
0 -1 -1 -1 -1 -1 0 0 0
0 -1 -1 -1 -1 -1 0 0 0
0 -1 -1 -1 -1 -1 0 0 0
0 -1 -1 -1 -1 -1 0 0 0
0 -1 -1 -1 -1 -1 0 0 0
0 -1 -1 -1 -1 -1 0 0 0
0 -1 -1 -1 -1 -1 0 0 0
0 -1 -1 -1 -1 -1 0 0 0
0 3 1 -1 -1 -1 0 0 0
6 4 1 -1 2 3 0 0 0
3 5 1 -1 -1 -1 0 0 0
1 6 1 -1 -1 -1 0 0 0
0 -1 -1 -1 -1 -1 0 0 0
0 -1 -1 -1 -1 -1 0 0 0
0 -1 -1 -1 -1 -1 0 0 0
0 -1 -1 -1 -1 -1 0 0 0
0 -1 -1 -1 -1 -1 0 0 0
0 1 2 -1 -1 -1 0 0 0
6 2 2 -1 4 0 0 0 0
0 -1 -1 -1 -1 -1 0 0 0
0 4 2 -1 -1 -1 0 0 0
6 5 2 -1 3 4 0 0 0
3 6 2 -1 -1 -1 0 0 0
1 7 2 -1 -1 -1 0 0 0
0 -1 -1 -1 -1 -1 0 0 0
0 -1 -1 -1 -1 -1 0 0 0
0 -1 -1 -1 -1 -1 0 0 0
0 0 3 -1 -1 -1 0 0 0
9 1 3 -1 -1 -1 0 0 0
5 2 3 5 -1 -1 0 0 0
6 3 3 -1 5 1 0 0 0
0 4 3 -1 -1 -1 0 0 0
0 5 3 -1 -1 -1 0 0 0
6 6 3 -1 4 5 0 0 0
3 7 3 -1 -1 -1 0 0 0
1 8 3 -1 -1 -1 0 0 0
0 -1 -1 -1 -1 -1 0 0 0
0 -1 -1 -1 -1 -1 0 0 0
0 -1 -1 -1 -1 -1 0 0 0
0 1 4 -1 -1 -1 0 0 0
9 2 4 -1 -1 -1 0 0 0
3 3 4 -1 -1 -1 0 0 0
6 4 4 -1 6 2 0 0 0
0 -1 -1 -1 -1 -1 0 0 0
0 6 4 -1 -1 -1 0 0 0
6 7 4 -1 5 6 0 0 0
4 8 4 -1 -1 -1 0 0 0
0 -1 -1 -1 -1 -1 0 0 0
0 -1 -1 -1 -1 -1 0 0 0
0 -1 -1 -1 -1 -1 0 0 0
0 1 5 -1 -1 -1 0 0 0
3 2 5 -1 -1 -1 0 0 0
4 3 5 -1 -1 -1 0 0 0
3 4 5 -1 -1 -1 0 0 0
6 5 5 -1 7 3 0 0 0
0 -1 -1 -1 -1 -1 0 0 0
0 -1 -1 -1 -1 -1 0 0 0
0 -1 -1 -1 -1 -1 0 0 0
0 -1 -1 -1 -1 -1 0 0 0
0 -1 -1 -1 -1 -1 0 0 0
0 -1 -1 -1 -1 -1 0 0 0
0 1 6 -1 -1 -1 0 0 0
2 2 6 -1 -1 -1 0 0 0
3 3 6 -1 -1 -1 0 0 0
9 4 6 -1 -1 -1 0 0 0
5 5 6 5 -1 -1 0 0 0
6 6 6 -1 8 4 0 0 0
0 7 6 -1 -1 -1 0 0 0
0 -1 -1 -1 -1 -1 0 0 0
0 -1 -1 -1 -1 -1 0 0 0
0 -1 -1 -1 -1 -1 0 0 0
0 -1 -1 -1 -1 -1 0 0 0
0 -1 -1 -1 -1 -1 0 0 0
0 -1 -1 -1 -1 -1 0 0 0
0 -1 -1 -1 -1 -1 0 0 0
0 4 7 -1 -1 -1 0 0 0
9 5 7 -1 -1 -1 0 0 0
0 6 7 -1 -1 -1 0 0 0
0 -1 -1 -1 -1 -1 0 0 0
0 -1 -1 -1 -1 -1 0 0 0
0 -1 -1 -1 -1 -1 0 0 0
0 -1 -1 -1 -1 -1 0 0 0
