0 -1 -1 -1 -1 -1 0 0 0
0 -1 -1 -1 -1 -1 0 0 0
0 -1 -1 -1 -1 -1 0 0 0
0 -1 -1 -1 -1 -1 0 0 0
0 -1 -1 -1 -1 -1 0 0 0
0 -1 -1 -1 -1 -1 0 0 0
0 -1 -1 -1 -1 -1 0 0 0
0 -1 -1 -1 -1 -1 0 0 0
0 -1 -1 -1 -1 -1 0 0 0
0 -1 -1 -1 -1 -1 0 0 0
0 -1 -1 -1 -1 -1 0 0 0
0 -1 -1 -1 -1 -1 0 0 0
0 -1 -1 -1 -1 -1 0 0 0
0 -1 -1 -1 -1 -1 0 0 0
9 3 1 -1 -1 -1 0 0 0
0 -1 -1 -1 -1 -1 0 0 0
7 5 1 -1 -1 -1 0 1 1
0 -1 -1 -1 -1 -1 0 0 0
9 7 1 -1 -1 -1 0 0 0
0 -1 -1 -1 -1 -1 0 0 0
0 -1 -1 -1 -1 -1 0 0 0
0 -1 -1 -1 -1 -1 0 0 0
0 -1 -1 -1 -1 -1 0 0 0
0 -1 -1 -1 -1 -1 0 0 0
1 2 2 -1 -1 -1 0 0 0
8 3 2 -1 -1 -1 3 0 0
0 -1 -1 -1 -1 -1 0 0 0
4 5 2 -1 -1 -1 0 0 0
0 -1 -1 -1 -1 -1 0 0 0
5 7 2 15 -1 -1 0 0 0
7 8 2 -1 -1 -1 0 2 1
0 -1 -1 -1 -1 -1 0 0 0
0 -1 -1 -1 -1 -1 0 0 0
0 -1 -1 -1 -1 -1 0 0 0
0 -1 -1 -1 -1 -1 0 0 0
0 -1 -1 -1 -1 -1 0 0 0
0 -1 -1 -1 -1 -1 0 0 0
0 -1 -1 -1 -1 -1 0 0 0
9 5 3 -1 -1 -1 0 0 0
0 -1 -1 -1 -1 -1 0 0 0
0 -1 -1 -1 -1 -1 0 0 0
0 -1 -1 -1 -1 -1 0 0 0
0 -1 -1 -1 -1 -1 0 0 0
0 -1 -1 -1 -1 -1 0 0 0
0 -1 -1 -1 -1 -1 0 0 0
1 1 4 -1 -1 -1 0 0 0
8 2 4 -1 -1 -1 2 0 0
9 3 4 -1 -1 -1 0 0 0
0 -1 -1 -1 -1 -1 0 0 0
2 5 4 -1 -1 -1 0 0 0
0 -1 -1 -1 -1 -1 0 0 0
6 7 4 -1 5 4 0 0 0
4 8 4 -1 -1 -1 0 0 0
7 9 4 -1 -1 -1 0 3 1
0 -1 -1 -1 -1 -1 0 0 0
0 -1 -1 -1 -1 -1 0 0 0
0 -1 -1 -1 -1 -1 0 0 0
0 2 5 -1 -1 -1 0 0 0
0 3 5 -1 -1 -1 1 0 0
0 4 5 -1 -1 -1 0 0 0
9 5 5 -1 -1 -1 0 0 0
0 -1 -1 -1 -1 -1 0 0 0
0 -1 -1 -1 -1 -1 0 0 0
0 -1 -1 -1 -1 -1 0 0 0
0 -1 -1 -1 -1 -1 0 0 0
0 -1 -1 -1 -1 -1 0 0 0
0 -1 -1 -1 -1 -1 0 0 0
0 -1 -1 -1 -1 -1 0 0 0
1 2 6 -1 -1 -1 0 0 0
8 3 6 -1 -1 -1 1 0 0
0 4 6 -1 -1 -1 0 0 0
4 5 6 -1 -1 -1 0 0 0
0 -1 -1 -1 -1 -1 0 0 0
5 7 6 15 -1 -1 0 0 0
7 8 6 -1 -1 -1 0 2 1
0 -1 -1 -1 -1 -1 0 0 0
0 -1 -1 -1 -1 -1 0 0 0
0 -1 -1 -1 -1 -1 0 0 0
0 -1 -1 -1 -1 -1 0 0 0
0 2 7 -1 -1 -1 0 0 0
9 3 7 -1 -1 -1 0 0 0
0 4 7 -1 -1 -1 0 0 0
7 5 7 -1 -1 -1 0 1 1
0 -1 -1 -1 -1 -1 0 0 0
9 7 7 -1 -1 -1 0 0 0
0 -1 -1 -1 -1 -1 0 0 0
0 -1 -1 -1 -1 -1 0 0 0
0 -1 -1 -1 -1 -1 0 0 0
