0, -1, -1, -1, -1, -1, 0, 0, 0
0, -1, -1, -1, -1, -1, 0, 0, 0
0, -1, -1, -1, -1, -1, 0, 0, 0
0, -1, -1, -1, -1, -1, 0, 0, 0
8, 4, 0, -1, -1, -1, 2, 0, 0
1, 5, 0, -1, -1, -1, 0, 0, 0
0, -1, -1, -1, -1, -1, 0, 0, 0
0, -1, -1, -1, -1, -1, 0, 0, 0
0, -1, -1, -1, -1, -1, 0, 0, 0
0, -1, -1, -1, -1, -1, 0, 0, 0
0, -1, -1, -1, -1, -1, 0, 0, 0
0, -1, -1, -1, -1, -1, 0, 0, 0
0, 1, 1, -1, -1, -1, 0, 0, 0
7, 2, 1, 10, -1, -1, 0, 1, 5
7, 3, 1, -1, -1, -1, 0, 1, 3
7, 4, 1, -1, -1, -1, 0, 2, 3
7, 5, 1, -1, -1, -1, 0, 2, 3
7, 6, 1, -1, -1, -1, 0, 2, 3
7, 7, 1, 10, -1, -1, 0, 2, 5
0, 8, 1, -1, -1, -1, 0, 0, 0
0, -1, -1, -1, -1, -1, 0, 0, 0
0, -1, -1, -1, -1, -1, 0, 0, 0
0, -1, -1, -1, -1, -1, 0, 0, 0
0, -1, -1, -1, -1, -1, 0, 0, 0
7, 2, 2, -1, -1, -1, 0, 1, 3
7, 3, 2, -1, -1, -1, 0, 1, 3
7, 4, 2, -1, -1, -1, 0, 1, 3
7, 5, 2, -1, -1, -1, 0, 1, 3
7, 6, 2, -1, -1, -1, 0, 1, 3
7, 7, 2, -1, -1, -1, 0, 2, 3
0, -1, -1, -1, -1, -1, 0, 0, 0
0, -1, -1, -1, -1, -1, 0, 0, 0
0, -1, -1, -1, -1, -1, 0, 0, 0
0, -1, -1, -1, -1, -1, 0, 0, 0
8, 1, 3, -1, -1, -1, 1, 0, 0
7, 2, 3, -1, -1, -1, 0, 1, 3
7, 3, 3, -1, -1, -1, 0, 1, 3
7, 4, 3, -1, -1, -1, 0, 1, 4
2, 5, 3, -1, -1, -1, 0, 0, 0
7, 6, 3, -1, -1, -1, 0, 1, 3
7, 7, 3, -1, -1, -1, 0, 2, 3
1, 8, 3, -1, -1, -1, 0, 0, 0
0, -1, -1, -1, -1, -1, 0, 0, 0
0, -1, -1, -1, -1, -1, 0, 0, 0
0, -1, -1, -1, -1, -1, 0, 0, 0
1, 1, 4, -1, -1, -1, 0, 0, 0
7, 2, 4, -1, -1, -1, 0, 4, 3
7, 3, 4, -1, -1, -1, 0, 4, 3
7, 4, 4, -1, -1, -1, 0, 4, 4
7, 5, 4, -1, -1, -1, 0, 3, 4
7, 6, 4, -1, -1, -1, 0, 3, 3
7, 7, 4, -1, -1, -1, 0, 3, 3
8, 8, 4, -1, -1, -1, 3, 0, 0
0, -1, -1, -1, -1, -1, 0, 0, 0
0, -1, -1, -1, -1, -1, 0, 0, 0
0, -1, -1, -1, -1, -1, 0, 0, 0
0, -1, -1, -1, -1, -1, 0, 0, 0
7, 2, 5, -1, -1, -1, 0, 4, 3
7, 3, 5, -1, -1, -1, 0, 3, 3
7, 4, 5, -1, -1, -1, 0, 3, 3
7, 5, 5, -1, -1, -1, 0, 3, 3
7, 6, 5, -1, -1, -1, 0, 3, 3
7, 7, 5, -1, -1, -1, 0, 3, 3
0, -1, -1, -1, -1, -1, 0, 0, 0
0, -1, -1, -1, -1, -1, 0, 0, 0
0, -1, -1, -1, -1, -1, 0, 0, 0
0, -1, -1, -1, -1, -1, 0, 0, 0
0, -1, -1, -1, -1, -1, 0, 0, 0
7, 2, 6, 10, -1, -1, 0, 4, 5
7, 3, 6, -1, -1, -1, 0, 4, 3
7, 4, 6, -1, -1, -1, 0, 4, 3
7, 5, 6, -1, -1, -1, 0, 3, 3
7, 6, 6, -1, -1, -1, 0, 3, 3
7, 7, 6, 10, -1, -1, 0, 3, 5
0, -1, -1, -1, -1, -1, 0, 0, 0
0, -1, -1, -1, -1, -1, 0, 0, 0
0, -1, -1, -1, -1, -1, 0, 0, 0
0, -1, -1, -1, -1, -1, 0, 0, 0
0, -1, -1, -1, -1, -1, 0, 0, 0
0, -1, -1, -1, -1, -1, 0, 0, 0
0, -1, -1, -1, -1, -1, 0, 0, 0
1, 4, 7, -1, -1, -1, 0, 0, 0
8, 5, 7, -1, -1, -1, 4, 0, 0
0, -1, -1, -1, -1, -1, 0, 0, 0
0, -1, -1, -1, -1, -1, 0, 0, 0
0, -1, -1, -1, -1, -1, 0, 0, 0
0, -1, -1, -1, -1, -1, 0, 0, 0
0, -1, -1, -1, -1, -1, 0, 0, 0
