0, -1, -1, -1, -1, -1, 0, 0, 0
0, -1, -1, -1, -1, -1, 0, 0, 0
0, -1, -1, -1, -1, -1, 0, 0, 0
0, -1, -1, -1, -1, -1, 0, 0, 0
0, -1, -1, -1, -1, -1, 0, 0, 0
2, 5, 0, -1, -1, -1, 0, 0, 0
0, -1, -1, -1, -1, -1, 0, 0, 0
0, -1, -1, -1, -1, -1, 0, 0, 0
0, -1, -1, -1, -1, -1, 0, 0, 0
0, -1, -1, -1, -1, -1, 0, 0, 0
0, -1, -1, -1, -1, -1, 0, 0, 0
0, -1, -1, -1, -1, -1, 0, 0, 0
0, -1, -1, -1, -1, -1, 0, 0, 0
0, -1, -1, -1, -1, -1, 0, 0, 0
7, 3, 1, -1, -1, -1, 0, 2, 3
3, 4, 1, -1, -1, -1, 0, 0, 0
3, 5, 1, -1, -1, -1, 0, 0, 0
3, 6, 1, -1, -1, -1, 0, 0, 0
7, 7, 1, -1, -1, -1, 0, 2, 3
0, -1, -1, -1, -1, -1, 0, 0, 0
0, -1, -1, -1, -1, -1, 0, 0, 0
0, -1, -1, -1, -1, -1, 0, 0, 0
0, -1, -1, -1, -1, -1, 0, 0, 0
0, 1, 2, -1, -1, -1, 0, 0, 0
0, 2, 2, -1, -1, -1, 0, 0, 0
3, 3, 2, -1, -1, -1, 0, 0, 0
0, -1, -1, -1, -1, -1, 0, 0, 0
3, 5, 2, -1, -1, -1, 0, 0, 0
0, -1, -1, -1, -1, -1, 0, 0, 0
3, 7, 2, -1, -1, -1, 0, 0, 0
0, 8, 2, -1, -1, -1, 0, 0, 0
0, 9, 2, -1, -1, -1, 0, 0, 0
0, -1, -1, -1, -1, -1, 0, 0, 0
0, -1, -1, -1, -1, -1, 0, 0, 0
3, 1, 3, -1, -1, -1, 0, 0, 0
3, 2, 3, -1, -1, -1, 0, 0, 0
4, 3, 3, -1, -1, -1, 0, 0, 0
3, 4, 3, -1, -1, -1, 0, 0, 0
7, 5, 3, -1, -1, -1, 0, 1, 3
3, 6, 3, -1, -1, -1, 0, 0, 0
4, 7, 3, -1, -1, -1, 0, 0, 0
3, 8, 3, -1, -1, -1, 0, 0, 0
3, 9, 3, -1, -1, -1, 0, 0, 0
0, -1, -1, -1, -1, -1, 0, 0, 0
0, -1, -1, -1, -1, -1, 0, 0, 0
5, 1, 4, 10, -1, -1, 0, 0, 0
0, -1, -1, -1, -1, -1, 0, 0, 0
0, -1, -1, -1, -1, -1, 0, 0, 0
0, -1, -1, -1, -1, -1, 0, 0, 0
3, 5, 4, -1, -1, -1, 0, 0, 0
0, -1, -1, -1, -1, -1, 0, 0, 0
0, -1, -1, -1, -1, -1, 0, 0, 0
0, -1, -1, -1, -1, -1, 0, 0, 0
5, 9, 4, 5, -1, -1, 0, 0, 0
0, -1, -1, -1, -1, -1, 0, 0, 0
0, -1, -1, -1, -1, -1, 0, 0, 0
3, 1, 5, -1, -1, -1, 0, 0, 0
3, 2, 5, -1, -1, -1, 0, 0, 0
8, 3, 5, -1, -1, -1, 2, 0, 0
3, 4, 5, -1, -1, -1, 0, 0, 0
4, 5, 5, -1, -1, -1, 0, 0, 0
3, 6, 5, -1, -1, -1, 0, 0, 0
8, 7, 5, -1, -1, -1, 1, 0, 0
3, 8, 5, -1, -1, -1, 0, 0, 0
3, 9, 5, -1, -1, -1, 0, 0, 0
0, -1, -1, -1, -1, -1, 0, 0, 0
0, -1, -1, -1, -1, -1, 0, 0, 0
0, -1, -1, -1, -1, -1, 0, 0, 0
0, -1, -1, -1, -1, -1, 0, 0, 0
3, 3, 6, -1, -1, -1, 0, 0, 0
0, -1, -1, -1, -1, -1, 0, 0, 0
3, 5, 6, -1, -1, -1, 0, 0, 0
0, -1, -1, -1, -1, -1, 0, 0, 0
3, 7, 6, -1, -1, -1, 0, 0, 0
0, -1, -1, -1, -1, -1, 0, 0, 0
0, -1, -1, -1, -1, -1, 0, 0, 0
0, -1, -1, -1, -1, -1, 0, 0, 0
0, -1, -1, -1, -1, -1, 0, 0, 0
0, -1, -1, -1, -1, -1, 0, 0, 0
0, -1, -1, -1, -1, -1, 0, 0, 0
5, 3, 7, 5, -1, -1, 0, 0, 0
3, 4, 7, -1, -1, -1, 0, 0, 0
1, 5, 7, -1, -1, -1, 0, 0, 0
3, 6, 7, -1, -1, -1, 0, 0, 0
5, 7, 7, 10, -1, -1, 0, 0, 0
0, -1, -1, -1, -1, -1, 0, 0, 0
0, -1, -1, -1, -1, -1, 0, 0, 0
0, -1, -1, -1, -1, -1, 0, 0, 0
