0 -1 -1 -1 -1 -1 0 0 0
0 -1 -1 -1 -1 -1 0 0 0
0 -1 -1 -1 -1 -1 0 0 0
0 -1 -1 -1 -1 -1 0 0 0
0 -1 -1 -1 -1 -1 0 0 0
0 -1 -1 -1 -1 -1 0 0 0
0 -1 -1 -1 -1 -1 0 0 0
0 -1 -1 -1 -1 -1 0 0 0
0 -1 -1 -1 -1 -1 0 0 0
0 -1 -1 -1 -1 -1 0 0 0
0 -1 -1 -1 -1 -1 0 0 0
0 -1 -1 -1 -1 -1 0 0 0
0 -1 -1 -1 -1 -1 0 0 0
0 -1 -1 -1 -1 -1 0 0 0
3 3 1 -1 -1 -1 0 0 0
0 -1 -1 -1 -1 -1 0 0 0
6 5 1 -1 3 1 0 0 0
7 6 1 -1 -1 -1 0 3 3
1 7 1 -1 -1 -1 0 0 0
0 -1 -1 -1 -1 -1 0 0 0
0 -1 -1 -1 -1 -1 0 0 0
0 -1 -1 -1 -1 -1 0 0 0
0 -1 -1 -1 -1 -1 0 0 0
0 -1 -1 -1 -1 -1 0 0 0
1 2 2 -1 -1 -1 0 0 0
3 3 2 -1 -1 -1 0 0 0
3 4 2 -1 -1 -1 0 0 0
6 5 2 -1 3 5 0 0 0
3 6 2 -1 -1 -1 0 0 0
3 7 2 -1 -1 -1 0 0 0
5 8 2 5 -1 -1 0 0 0
0 -1 -1 -1 -1 -1 0 0 0
0 -1 -1 -1 -1 -1 0 0 0
0 -1 -1 -1 -1 -1 0 0 0
0 -1 -1 -1 -1 -1 0 0 0
7 2 3 5 -1 -1 0 2 1
4 3 3 -1 -1 -1 0 0 0
5 4 3 5 -1 -1 0 0 0
8 5 3 -1 -1 -1 2 0 0
3 6 3 -1 -1 -1 0 0 0
3 7 3 -1 -1 -1 0 0 0
0 -1 -1 -1 -1 -1 0 0 0
0 -1 -1 -1 -1 -1 0 0 0
0 -1 -1 -1 -1 -1 0 0 0
0 -1 -1 -1 -1 -1 0 0 0
0 -1 -1 -1 -1 -1 0 0 0
6 2 4 -1 2 6 0 0 0
6 3 4 -1 4 4 0 0 0
8 4 4 -1 -1 -1 1 0 0
2 5 4 -1 -1 -1 0 0 0
8 6 4 -1 -1 -1 3 0 0
6 7 4 -1 6 4 0 0 0
6 8 4 -1 8 2 0 0 0
0 -1 -1 -1 -1 -1 0 0 0
0 -1 -1 -1 -1 -1 0 0 0
0 -1 -1 -1 -1 -1 0 0 0
0 -1 -1 -1 -1 -1 0 0 0
0 -1 -1 -1 -1 -1 0 0 0
3 3 5 -1 -1 -1 0 0 0
3 4 5 -1 -1 -1 0 0 0
8 5 5 -1 -1 -1 4 0 0
5 6 5 5 -1 -1 0 0 0
4 7 5 -1 -1 -1 0 0 0
7 8 5 -1 -1 -1 0 4 1
0 -1 -1 -1 -1 -1 0 0 0
0 -1 -1 -1 -1 -1 0 0 0
0 -1 -1 -1 -1 -1 0 0 0
0 -1 -1 -1 -1 -1 0 0 0
5 2 6 5 -1 -1 0 0 0
3 3 6 -1 -1 -1 0 0 0
4 4 6 -1 -1 -1 0 0 0
6 5 6 -1 5 5 0 0 0
3 6 6 -1 -1 -1 0 0 0
3 7 6 -1 -1 -1 0 0 0
1 8 6 -1 -1 -1 0 0 0
0 -1 -1 -1 -1 -1 0 0 0
0 -1 -1 -1 -1 -1 0 0 0
0 -1 -1 -1 -1 -1 0 0 0
0 -1 -1 -1 -1 -1 0 0 0
0 -1 -1 -1 -1 -1 0 0 0
1 3 7 -1 -1 -1 0 0 0
7 4 7 -1 -1 -1 0 1 3
6 5 7 -1 7 7 0 0 0
0 -1 -1 -1 -1 -1 0 0 0
3 7 7 -1 -1 -1 0 0 0
0 -1 -1 -1 -1 -1 0 0 0
0 -1 -1 -1 -1 -1 0 0 0
0 -1 -1 -1 -1 -1 0 0 0
