0 -1 -1 -1 -1 -1 0 0 0
0 -1 -1 -1 -1 -1 0 0 0
0 -1 -1 -1 -1 -1 0 0 0
0 -1 -1 -1 -1 -1 0 0 0
2 4 0 -1 -1 -1 0 0 0
6 5 0 -1 5 3 0 0 0
8 6 0 -1 -1 -1 2 0 0
0 -1 -1 -1 -1 -1 0 0 0
0 -1 -1 -1 -1 -1 0 0 0
0 -1 -1 -1 -1 -1 0 0 0
0 -1 -1 -1 -1 -1 0 0 0
0 -1 -1 -1 -1 -1 0 0 0
0 -1 -1 -1 -1 -1 0 0 0
0 -1 -1 -1 -1 -1 0 0 0
9 3 1 -1 -1 -1 0 0 0
0 -1 -1 -1 -1 -1 0 0 0
0 -1 -1 -1 -1 -1 0 0 0
5 6 1 5 -1 -1 0 0 0
3 7 1 -1 -1 -1 0 0 0
0 -1 -1 -1 -1 -1 0 0 0
0 -1 -1 -1 -1 -1 0 0 0
0 -1 -1 -1 -1 -1 0 0 0
0 -1 -1 -1 -1 -1 0 0 0
1 1 2 -1 -1 -1 0 0 0
4 2 2 -1 -1 -1 0 0 0
3 3 2 -1 -1 -1 0 0 0
7 4 2 -1 4 0 0 1 6
0 -1 -1 -1 -1 -1 0 0 0
0 -1 -1 -1 -1 -1 0 0 0
3 7 2 -1 -1 -1 0 0 0
5 8 2 5 -1 -1 0 0 0
0 -1 -1 -1 -1 -1 0 0 0
0 -1 -1 -1 -1 -1 0 0 0
0 -1 -1 -1 -1 -1 0 0 0
0 -1 -1 -1 -1 -1 0 0 0
0 -1 -1 -1 -1 -1 0 0 0
6 3 3 -1 1 5 0 0 0
0 -1 -1 -1 -1 -1 0 0 0
9 5 3 -1 -1 -1 0 0 0
0 -1 -1 -1 -1 -1 0 0 0
1 7 3 -1 -1 -1 0 0 0
4 8 3 -1 -1 -1 0 0 0
0 -1 -1 -1 -1 -1 0 0 0
0 -1 -1 -1 -1 -1 0 0 0
0 -1 -1 -1 -1 -1 0 0 0
0 -1 -1 -1 -1 -1 0 0 0
0 -1 -1 -1 -1 -1 0 0 0
6 3 4 -1 1 2 0 0 0
0 -1 -1 -1 -1 -1 0 0 0
9 5 4 -1 -1 -1 0 0 0
0 -1 -1 -1 -1 -1 0 0 0
1 7 4 -1 -1 -1 0 0 0
3 8 4 -1 -1 -1 0 0 0
0 -1 -1 -1 -1 -1 0 0 0
0 -1 -1 -1 -1 -1 0 0 0
0 -1 -1 -1 -1 -1 0 0 0
1 1 5 -1 -1 -1 0 0 0
4 2 5 -1 -1 -1 0 0 0
3 3 5 -1 -1 -1 0 0 0
7 4 5 -1 4 0 0 2 6
0 -1 -1 -1 -1 -1 0 0 0
0 -1 -1 -1 -1 -1 0 0 0
3 7 5 -1 -1 -1 0 0 0
5 8 5 5 -1 -1 0 0 0
0 -1 -1 -1 -1 -1 0 0 0
0 -1 -1 -1 -1 -1 0 0 0
0 -1 -1 -1 -1 -1 0 0 0
0 -1 -1 -1 -1 -1 0 0 0
0 -1 -1 -1 -1 -1 0 0 0
9 3 6 -1 -1 -1 0 0 0
0 -1 -1 -1 -1 -1 0 0 0
0 5 6 -1 5 4 0 0 0
5 6 6 5 -1 -1 0 0 0
3 7 6 -1 -1 -1 0 0 0
0 -1 -1 -1 -1 -1 0 0 0
0 -1 -1 -1 -1 -1 0 0 0
0 -1 -1 -1 -1 -1 0 0 0
0 -1 -1 -1 -1 -1 0 0 0
0 -1 -1 -1 -1 -1 0 0 0
0 -1 -1 -1 -1 -1 0 0 0
0 -1 -1 -1 -1 -1 0 0 0
0 -1 -1 -1 -1 -1 0 0 0
6 5 7 -1 5 4 0 0 0
8 6 7 -1 -1 -1 1 0 0
0 -1 -1 -1 -1 -1 0 0 0
0 -1 -1 -1 -1 -1 0 0 0
0 -1 -1 -1 -1 -1 0 0 0
0 -1 -1 -1 -1 -1 0 0 0
