7 0 0 -1 -1 -1 0 0 0
7 1 0 -1 -1 -1 0 0 0
7 2 0 -1 -1 -1 0 0 0
7 3 0 -1 -1 -1 0 0 0
7 4 0 -1 -1 -1 0 0 0
7 5 0 -1 -1 -1 0 0 0
7 6 0 -1 -1 -1 0 0 0
7 7 0 -1 -1 -1 0 0 0
7 8 0 -1 -1 -1 0 0 0
7 9 0 -1 -1 -1 0 0 0
7 10 0 -1 -1 -1 0 0 0
7 0 1 -1 -1 -1 0 0 0
0 -1 -1 -1 -1 -1 0 0 0
0 -1 -1 -1 -1 -1 0 0 0
0 -1 -1 -1 -1 -1 0 0 0
0 -1 -1 -1 -1 -1 0 0 0
0 -1 -1 -1 -1 -1 0 0 0
0 -1 -1 -1 -1 -1 0 0 0
0 -1 -1 -1 -1 -1 0 0 0
0 -1 -1 -1 -1 -1 0 0 0
0 -1 -1 -1 -1 -1 0 0 0
7 10 1 -1 -1 -1 0 0 0
7 0 2 -1 -1 -1 0 0 0
0 -1 -1 -1 -1 -1 0 0 0
0 -1 -1 -1 -1 -1 0 0 0
1 3 2 -1 -1 -1 0 0 0
3 4 2 -1 -1 -1 0 0 0
4 5 2 -1 -1 -1 0 0 0
4 6 2 -1 -1 -1 0 0 0
0 -1 -1 -1 -1 -1 0 0 0
0 -1 -1 -1 -1 -1 0 0 0
0 -1 -1 -1 -1 -1 0 0 0
7 10 2 -1 -1 -1 0 0 0
7 0 3 -1 -1 -1 0 0 0
0 -1 -1 -1 -1 -1 0 0 0
0 -1 -1 -1 -1 -1 0 0 0
0 -1 -1 -1 -1 -1 0 0 0
0 -1 -1 -1 -1 -1 0 0 0
0 -1 -1 -1 -1 -1 0 0 0
4 6 3 -1 -1 -1 0 0 0
0 -1 -1 -1 -1 -1 0 0 0
0 -1 -1 -1 -1 -1 0 0 0
0 -1 -1 -1 -1 -1 0 0 0
7 10 3 -1 -1 -1 0 0 0
7 0 4 -1 -1 -1 0 0 0
0 1 4 -1 -1 -1 0 0 0
0 2 4 -1 -1 -1 0 0 0
0 3 4 -1 -1 -1 0 0 0
2 4 4 -1 -1 -1 0 0 0
6 5 4 -1 4 4 0 0 0
5 6 4 5 -1 -1 0 0 0
0 -1 -1 -1 -1 -1 0 0 0
0 -1 -1 -1 -1 -1 0 0 0
0 -1 -1 -1 -1 -1 0 0 0
7 10 4 -1 -1 -1 0 0 0
7 0 5 -1 -1 -1 0 0 0
0 -1 -1 -1 -1 -1 0 0 0
0 -1 -1 -1 -1 -1 0 0 0
0 -1 -1 -1 -1 -1 0 0 0
0 -1 -1 -1 -1 -1 0 0 0
0 -1 -1 -1 -1 -1 0 0 0
0 -1 -1 -1 -1 -1 0 0 0
0 -1 -1 -1 -1 -1 0 0 0
0 -1 -1 -1 -1 -1 0 0 0
0 -1 -1 -1 -1 -1 0 0 0
7 10 5 -1 -1 -1 0 0 0
7 0 6 -1 -1 -1 0 0 0
0 -1 -1 -1 -1 -1 0 0 0
0 -1 -1 -1 -1 -1 0 0 0
0 -1 -1 -1 -1 -1 0 0 0
0 -1 -1 -1 -1 -1 0 0 0
0 -1 -1 -1 -1 -1 0 0 0
0 -1 -1 -1 -1 -1 0 0 0
0 -1 -1 -1 -1 -1 0 0 0
0 -1 -1 -1 -1 -1 0 0 0
0 -1 -1 -1 -1 -1 0 0 0
7 10 6 -1 -1 -1 0 0 0
7 0 7 -1 -1 -1 0 0 0
7 1 7 -1 -1 -1 0 0 0
7 2 7 -1 -1 -1 0 0 0
7 3 7 -1 -1 -1 0 0 0
7 4 7 -1 -1 -1 0 0 0
7 5 7 -1 -1 -1 0 0 0
7 6 7 -1 -1 -1 0 0 0
7 7 7 -1 -1 -1 0 0 0
7 8 7 -1 -1 -1 0 0 0
7 9 7 -1 -1 -1 0 0 0
7 10 7 -1 -1 -1 0 0 0
