0 -1 -1 -1 -1 -1 0 0 0
0 -1 -1 -1 -1 -1 0 0 0
0 -1 -1 -1 -1 -1 0 0 0
0 -1 -1 -1 -1 -1 0 0 0
0 -1 -1 -1 -1 -1 0 0 0
0 -1 -1 -1 -1 -1 0 0 0
0 -1 -1 -1 -1 -1 0 0 0
0 -1 -1 -1 -1 -1 0 0 0
0 -1 -1 -1 -1 -1 0 0 0
0 -1 -1 -1 -1 -1 0 0 0
0 -1 -1 -1 -1 -1 0 0 0
0 -1 -1 -1 -1 -1 0 0 0
0 -1 -1 -1 -1 -1 0 0 0
0 -1 -1 -1 -1 -1 0 0 0
3 3 1 -1 -1 -1 0 0 0
3 4 1 -1 -1 -1 0 0 0
3 5 1 -1 -1 -1 0 0 0
0 -1 -1 -1 -1 -1 0 0 0
0 -1 -1 -1 -1 -1 0 0 0
0 -1 -1 -1 -1 -1 0 0 0
0 -1 -1 -1 -1 -1 0 0 0
0 -1 -1 -1 -1 -1 0 0 0
0 -1 -1 -1 -1 -1 0 0 0
0 -1 -1 -1 -1 -1 0 0 0
1 2 2 -1 -1 -1 0 0 0
3 3 2 -1 -1 -1 0 0 0
0 -1 -1 -1 -1 -1 0 0 0
3 5 2 -1 -1 -1 0 0 0
6 6 2 -1 6 7 0 0 0
0 -1 -1 -1 -1 -1 0 0 0
0 -1 -1 -1 -1 -1 0 0 0
0 -1 -1 -1 -1 -1 0 0 0
0 -1 -1 -1 -1 -1 0 0 0
0 -1 -1 -1 -1 -1 0 0 0
3 1 3 -1 -1 -1 0 0 0
3 2 3 -1 -1 -1 0 0 0
0 -1 -1 -1 -1 -1 0 0 0
6 4 3 -1 3 4 0 0 0
4 5 3 -1 -1 -1 0 0 0
6 6 3 -1 6 7 0 0 0
5 7 3 5 -1 -1 0 0 0
3 8 3 -1 -1 -1 0 0 0
1 9 3 -1 -1 -1 0 0 0
0 -1 -1 -1 -1 -1 0 0 0
0 -1 -1 -1 -1 -1 0 0 0
3 1 4 -1 -1 -1 0 0 0
0 -1 -1 -1 -1 -1 0 0 0
6 3 4 -1 4 4 0 0 0
2 4 4 -1 -1 -1 0 0 0
3 5 4 -1 -1 -1 0 0 0
0 -1 -1 -1 -1 -1 0 0 0
3 7 4 -1 -1 -1 0 0 0
9 8 4 -1 -1 -1 0 0 0
3 9 4 -1 -1 -1 0 0 0
0 -1 -1 -1 -1 -1 0 0 0
0 -1 -1 -1 -1 -1 0 0 0
3 1 5 -1 -1 -1 0 0 0
4 2 5 -1 -1 -1 0 0 0
3 3 5 -1 -1 -1 0 0 0
3 4 5 -1 -1 -1 0 0 0
5 5 5 5 -1 -1 0 0 0
6 6 5 -1 6 7 0 0 0
3 7 5 -1 -1 -1 0 0 0
3 8 5 -1 -1 -1 0 0 0
4 9 5 -1 -1 -1 0 0 0
0 -1 -1 -1 -1 -1 0 0 0
0 -1 -1 -1 -1 -1 0 0 0
0 -1 -1 -1 -1 -1 0 0 0
0 -1 -1 -1 -1 -1 0 0 0
0 -1 -1 -1 -1 -1 0 0 0
0 -1 -1 -1 -1 -1 0 0 0
0 -1 -1 -1 -1 -1 0 0 0
0 -1 -1 -1 -1 -1 0 0 0
0 -1 -1 -1 -1 -1 0 0 0
0 -1 -1 -1 -1 -1 0 0 0
0 -1 -1 -1 -1 -1 0 0 0
0 -1 -1 -1 -1 -1 0 0 0
0 -1 -1 -1 -1 -1 0 0 0
0 -1 -1 -1 -1 -1 0 0 0
0 -1 -1 -1 -1 -1 0 0 0
0 -1 -1 -1 -1 -1 0 0 0
0 -1 -1 -1 -1 -1 0 0 0
6 5 7 -1 5 5 0 0 0
5 6 7 10 -1 -1 0 0 0
6 7 7 -1 7 5 0 0 0
0 -1 -1 -1 -1 -1 0 0 0
0 -1 -1 -1 -1 -1 0 0 0
0 -1 -1 -1 -1 -1 0 0 0
